








          ###         ###                        ##             ###
              P   P            #  #                 P                            F
                              ##  ##
                             ###  ###                          #####
##########  ####################  ################################################
##########  ####################  ##############################################################################

