








        ###         ###                        ##             ###
              P   P            #  #                 P                            F
                              ##  ##
                             ###  ###                          #####
##############################  ##############################################################################
##############################  ##############################################################################

