








          ###         ###                                       ###
    P                          #  #                 P                            F
                              ##  ##
                             ###  ###
##########  ####################  ################################################
##########  ####################  ################################################

