








                 ###                       ###              ###
              P   P              #  #             F     P                           
                                ##  ##
                               ###  ###                          #####
######### ######################  ##############################################################################
######### ######################  ##############################################################################


