








        ###           ###                       ###              ###
              P   P              #  #                 P                            F
                                ##  ##
                               ###  ###                          #####
#########   ######################  ##############################################################################
#########   ######################  ##############################################################################

