








          ###         ###                        ##             ###
              P   P            #  #                 P                            F
                              ##  ##
                             ###  ###                          #####
########## ####################  ##############################################################################
########## ####################  ##############################################################################

