








          ###         ###                                       ###
    P                          #  #                 P                            F
                              ##  ##
                             ###  ###
##############################  ################################################
##############################  ################################################

