








          ###         ###                                       ###
    P                          #  #              F
                              ##  ##
                             ###  ###
##############################  ################################################
##############################  ################################################

