








                 ###                       ###              ###
              P   P              #  #             F     P                           
                                ##  ##
                               ###  ###                          #####
######### #############  #########  ##############################################################################
######### #############  #########  ##############################################################################


