








          ###         ###                        ##             ###
              P   P            #  #                 P                            F
                              ##  ##
                             ###  ###
##############################  ################################################
##############################  ################################################

