








        ###         ###                       ###              ###
              P   P           #  #                 P                            F
                             ##  ##
                            ###  ###                          #####
#########   ###################  ##############################################################################
#########   ###################  ##############################################################################

